Forgotten Saga=Забытая Сага
New game=Новая игра
High scores table=Таблица рекордов
About=Об авторах
Quit=Выход
Continue=Продолжить
Save game=Сохранить игру
Load game=Загрузить игру
Exit game=Завершить
Select race=Выбери расу
Orc=Орк
Troll=Троль
Goblin=Гоблин
What is your name?=Выбери имя героя
Random name=Генерировать
Back to main menu=Вернуться в главное меню
Quest log=Журнал заданий
Honor=Честь
Close=Закрыть
Save=Сохранить
Load=Загрузить
Read=Читать
Back=Назад
%s %s %d level=%s %s %d-го уровня
Exp=Опыт
Life=Жизнь
Mana=Магия
Adrenalin=Адреналин
Honor=Слава
Victory!=Победа!
Defeat!=Поражение!
Inventory=Инвентарь
Pickup all items=Поднять все предметы
Items=Предметы
You pick up a %s.=Ты поднял %s.
You are carrying a too much!=Ты перегружен!
Empty slot=Пустой слот
Goblin_name1=Авгу,Лео,Тан,Шо,Пенр,Лок,Грон,Лар,Мидр
Goblin_name2=син,нег,зар,кар,тун,рел,бал,рин,кон
Goblin_name3=ор,фин,шог,тал,род,пин,ол,кан,он
Orc_name1=Хад,Род,Шаг,Дор,Лид,Тар,Крэг,Брон,Шунг
Orc_name2=Гарум,Турум,Ур,Утак,Удум,Уд,Урак,Дун,Вуг
Orc_name3=Кат,Шак,Гир,Буд,Дрэг,Дин,Грок,Риг,Садр
Troll_name1=Слепой,Яростный,Гордый,Зоркий,Могучий,Танцующий,Стерегущий,Громовой,Ночной
Troll_name2=Волкодав,Моховик,Обрушитель,Крушитель,Следопыт,Звездочет,Волопас,Смотритель,Осквернитель

